_____________
#%#_#%#%#_#%#
%_____%____%_
___#_____#___
%%%#____#%%%_
___#_____#___
%%%%%%%%%%%%%
___#_____#___
%%%#____#%%%_
___#_____#___
%_____%____%_
###__%B%__###
#%#%#%#%#%#%#