#%#%#%#%#%#%#
%_____%____%_
___#_____#___
%%%#____#%%%
___#_____#___
%%%%%%%%%%%%%
___#_____#___
%%%#____#%%%
___#_____#___
%_____%____%_
###__%B%__###
#%#%#%#%#%#%#