#_____#_____#
_%_________%_
___%__#__%___
_____%_%_____
#_____#_____#
__#__%_%_#___
___%_____%___
_%_________%_
%____#____#__
B%_____#_____
%___#_____#__
#_#_#_#_#_#_
#_____#_____#